################
#@#*########   #
# #      # # # #
# ###### #   # #
#        # ##  #
## # ### # #  ##
## # #     # ###
##     #####   #
############## #
#   #    #   # #
#%#   #    #   #
################